NO ./asset/texture/konoha_leaf_wall.png
SO ./asset/texture/hokage_rock.png
WE ./asset/texture/ninja_scrolls.png
EA ./asset/texture/shoji_screen.png

F 139,69,19
C 135,206,235

111111111111111111111
100000000000000000001
101111111000111111101
100000001000100000001
100N00001000100000001
100000001000111111101
100000001000000000001
100000001111111111111
100000000000000000001
100000000000000000001
111111111111111111111