NO ./asset/texture/shoji_wall_north.png
SO ./asset/texture/bamboo_wall_south.png
WE ./asset/texture/stone_wall_west.png
EA ./asset/texture/temple_wall_east.png

F 40,40,35
C 15,15,20

11111111111111111111
10000000000000000001
10000111110000011101
10000100010000000001
10000100011111000001
10000100000001000001
11110111110001000001
10000000000001000001
10011111111111000001
10000000000000000N01
11111111111111111111