EA ./asset/texture/south.png
WE ./asset/texture/south.png
SO ./asset/texture/south.png
NO ./asset/texture/north.png

F 220,100,0
C 225,30,0

111111
100101
1010N1
1100N1
111111